NO textures/north.xpm
SO textures/south.xpm
EA textures/east.xpm
WE textures/west.xpm
F 220, 220, 0
C 0, 0, 0 

111111111
100000000111
100000N001
100000001
11111111