NO textures/north.xpm
SO textures/south.xpm
EA textures/east.xpm
WE textures/west.xpm
F 220, 220, 0
C 0, 0, 0 

11111111
100000101
100001S101
100000101
11111111