NO textures/north.xpm
SO textures/south.xpm
EA textures/east.xpm 
WE textures/west.xpm
F 220, 220, 220 
C 0, 0, 0  


11111111111111111
10000000000001100111
100111011111100000001
10000S00000000001111
1111111110111111
11111111111 111