NO textures/north.xpm
SO textures/south.xpm
EA textures/east.xpm
WE textures/west.xpm
F 220, 220, 0
C 0, 0, 0

1111111111111 111
10000000000001100111
100111011111100000001
10000S000000000011111
1111111101111111
    111111